01000000000111
01111111111111
01000000000111
01000000000111
01000000000111
01000000000111
01000000000111
01000000000111
01000000000111
01000000000111
01000000000111
01000000000011
01111111111111
00000000000111
