000000000
011111110
010000010
010010010
010000310
010000010
011201010
011111110
000000000
