0000000000
0111111110
0100010010
0100100010
0104000010
0110000110
0105021010
0111111110
0000000000
