000000000000
000000001000
001000100000
000010000000
000000000100
000100000000
000000001000
000001000000
002000000100
000000000000
000000031000
000000000000
