2022222222222222222222222
2000000222222200000000002
2022222222222200000000002
2222222222220220022222222
2222222222220200000200002
2222222222220200000000002
2220000000020200000000002
2022222222220200000000002
2022222222220200022222222
2000000000020200000000002
2000000000020200000000002
2000000000020200000000002
2022222222222200000000002
2000000000000200000000002
2022222200000000000000002
2020000000222222222222202
2020000000000000000000002
2022222222222000000000002
2000000000000000000000002
2000000000002222222222222
2000000000000000002000002
2000000000000000002000002
2000000000000000000000000
2000000000000000000000000
2222222222222222222222222


one = white
zero = green
two = black
